5 1 1 1 1 1 1 1 1 1 1 1 1 1 1 1 1 1 1 1 1 1 1 1 6
4 9 9 9 9 9 9 9 9 9 9 9 9 9 9 9 9 9 9 9 9 9 9 9 3
4 10 10 10 10 10 10 10 10 10 10 10 10 10 10 10 10 10 10 10 10 10 10 10 3
4 20 20 20 20 20 20 20 20 20 20 20 20 20 20 20 20 20 20 20 20 20 20 20 3
4 0 0 0 0 0 0 0 0 0 0 0 0 0 0 0 0 0 0 0 0 0 0 0 3
4 0 0 0 0 0 0 0 0 0 0 0 0 0 0 0 0 0 0 0 0 0 0 0 3
4 0 0 18 13 0 0 0 0 0 18 12 12 12 12 12 12 12 12 12 12 13 0 0 3
4 0 0 19 11 0 0 0 0 0 19 10 10 10 10 10 10 10 10 10 10 11 0 0 3
4 0 0 20 20 0 0 0 0 0 20 20 20 20 20 20 20 20 20 20 20 20 0 0 3
4 0 0 0 0 0 0 0 0 0 0 0 0 0 0 0 0 0 0 0 0 0 0 0 3
4 0 0 0 0 0 0 0 0 0 0 0 0 0 0 0 0 0 0 0 0 0 0 0 3
4 0 0 18 12 12 12 13 0 0 0 0 0 0 0 0 0 0 0 0 0 0 0 0 3
4 0 0 19 10 10 10 11 0 0 0 0 0 0 18 12 12 13 0 0 0 0 0 0 3
4 0 0 20 20 20 20 20 0 0 0 0 0 0 19 10 10 11 0 0 0 0 0 0 3
4 0 0 0 0 0 0 0 0 0 0 0 0 0 20 20 20 20 0 0 0 0 0 0 3
4 0 0 0 0 0 0 0 0 0 0 0 0 0 0 0 0 0 0 0 0 0 0 0 3
4 0 0 18 12 12 12 12 12 12 12 13 0 0 0 0 0 0 0 0 0 0 0 0 3
4 0 0 19 10 10 10 10 10 10 10 11 0 0 0 0 0 0 0 0 0 0 0 0 3
4 0 0 20 20 20 20 20 20 20 20 20 0 0 0 0 0 0 0 0 0 0 0 0 3
4 0 0 0 0 0 0 21 0 0 0 0 0 0 0 0 0 0 0 0 0 0 0 0 3
4 0 0 0 0 0 0 15 0 0 0 0 0 0 0 18 13 0 0 0 0 0 0 0 3
4 0 0 0 0 0 0 16 0 0 0 17 0 0 0 19 11 0 0 0 0 0 0 0 3
4 0 0 0 0 0 0 20 0 0 0 14 0 0 0 20 20 0 0 0 0 0 0 0 3
4 0 0 0 0 0 0 0 0 0 0 14 0 0 0 0 0 0 0 0 0 0 0 0 3
7 2 2 2 2 2 2 2 2 2 2 2 2 2 2 2 2 2 2 2 2 2 2 2 8